############
...#..#....#
#.##.##.##.#
#.....#..#.#
####.#####.#
#...........
############